+----+----+----+----+----+----+----+----+----+----+----+----+----+----+----+----+----+----+
S    |         |              |         |                   |                             |
     |         |              |         |                   |                             |
     |         |              |         |                   |                             |
     |         |              |         |                   |                             |
+    +    +    +----+----+    +----+    +----+----+----+    +    +----+----+----+----+    +
|    |    |         |              |                   |    |                   |         |
|    |    |         |              |                   |    |                   |         |
|    |    |         |              |                   |    |                   |         |
|    |    |         |              |                   |    |                   |         |
+    +    +----+    +    +----+    +----+----+----+    +    +----+----+----+    +    +----+
|    |         |    |         |    |                   |    |         |         |    |    |
|    |         |    |         |    |                   |    |         |         |    |    |
|    |         |    |         |    |                   |    |         |         |    |    |
|    |         |    |         |    |                   |    |         |         |    |    |
+    +----+----+    +----+----+    +    +----+----+----+    +    +    +----+----+    +    +
|              |                   |    |         |         |    |                   |    |
|              |                   |    |         |         |    |                   |    |
|              |                   |    |         |         |    |                   |    |
|              |                   |    |         |         |    |                   |    |
+----+----+    +    +----+----+    +    +    +    +    +----+    +    +----+----+----+    +
|              |              |         |    |         |    |    |    |         |         |
|              |              |         |    |         |    |    |    |         |         |
|              |              |         |    |         |    |    |    |         |         |
|              |              |         |    |         |    |    |    |         |         |
+    +----+----+----+----+    +    +----+    +----+----+    +    +    +    +    +    +----+
|    |         |         |    |         |    |    |              |         |    |    |    |
|    |         |         |    |         |    |    |              |         |    |    |    |
|    |         |         |    |         |    |    |              |         |    |    |    |
|    |         |         |    |         |    |    |              |         |    |    |    |
+    +    +    +    +    +    +----+----+    +    +    +    +----+----+----+    +    +    +
|    |    |         |         |         |         |    |    |              |              |
|    |    |         |         |         |         |    |    |              |              |
|    |    |         |         |         |         |    |    |              |              |
|    |    |         |         |         |         |    |    |              |              |
+    +    +----+----+----+----+    +    +----+    +    +    +    +----+    +----+    +----+
|    |         |         |    |    |    |              |    |    |    |    |         |    |
|    |         |         |    |    |    |              |    |    |    |    |         |    |
|    |         |         |    |    |    |              |    |    |    |    |         |    |
|    |         |         |    |    |    |              |    |    |    |    |         |    |
+    +    +    +    +    +    +    +    +----+----+----+    +    +    +    +    +----+    +
|    |    |    |    |              |                        |         |         |         |
|    |    |    |    |              |                        |         |         |         |
|    |    |    |    |              |                        |         |         |         |
|    |    |    |    |              |                        |         |         |         |
+    +    +    +    +----+----+    +----+----+----+    +----+----+----+----+----+----+    +
|         |    |              |         |              |                        |         |
|         |    |              |         |              |                        |         |
|         |    |              |         |              |                        |         |
|         |    |              |         |              |                        |         |
+----+----+    +----+----+    +----+    +    +----+----+    +----+    +----+----+    +----+
|              |         |    |         |              |    |         |         |    |    |
|              |         |    |         |              |    |         |         |    |    |
|              |         |    |         |              |    |         |         |    |    |
|              |         |    |         |              |    |         |         |    |    |
+    +----+----+    +----+    +----+    +----+----+    +    +    +    +    +    +    +    +
|              |         |         |    |              |    |    |    |    |    |         |
|              |         |         |    |              |    |    |    |    |    |         |
|              |         |         |    |              |    |    |    |    |    |         |
|              |         |         |    |              |    |    |    |    |    |         |
+----+----+    +----+    +----+    +    +    +----+----+----+    +    +    +    +    +----+
|                   |    |         |    |                        |         |    |         |
|                   |    |         |    |                        |         |    |         |
|                   |    |         |    |                        |         |    |         |
|                   |    |         |    |                        |         |    |         |
+    +----+----+----+    +    +----+    +----+    +----+----+----+----+----+    +----+    +
|         |         |              |    |    |    |         |              |              |
|         |         |              |    |    |    |         |              |              |
|         |         |              |    |    |    |         |              |              |
|         |         |              |    |    |    |         |              |              |
+----+    +    +    +----+----+    +    +    +    +    +    +----+    +----+----+----+    +
|              |    |         |    |    |    |         |         |    |         |         |
|              |    |         |    |    |    |         |         |    |         |         |
|              |    |         |    |    |    |         |         |    |         |         |
|              |    |         |    |    |    |         |         |    |         |         |
+    +----+----+----+    +    +----+    +    +----+----+----+    +    +    +----+    +----+
|    |                   |         |    |                        |                        |
|    |                   |         |    |                        |                        |
|    |                   |         |    |                        |                        |
|    |                   |         |    |                        |                        |
+    +    +----+----+----+----+    +    +----+----+----+----+----+----+----+    +----+----+
|    |    |         |              |         |                        |                   |
|    |    |         |              |         |                        |                   |
|    |    |         |              |         |                        |                   |
|    |    |         |              |         |                        |                   |
+    +    +    +    +    +    +----+----+    +    +----+----+----+    +    +----+----+    +
|         |    |         |                   |                   |         |               
|         |    |         |                   |                   |         |               
|         |    |         |                   |                   |         |_              
|         |    |         |                   |                   |         | |            E
+----+----+----+----+----+----+----+----+----+----+----+----+----+----+----+----+----+----+