+----+----+----+----+----+----+
S         |         |         |
          |         |         |
          |         |         |
          |         |         |
+    +    +----+    +    +    +
|    |         |    |    |    |
|    |         |    |    |    |
|    |         |    |    |    |
|    |         |    |    |    |
+----+----+    +    +    +    +
|              |         |    |
|              |         |    |
|              |         |    |
|              |         |    |
+    +----+----+----+    +    +
|                        |    |
|                        |    |
|                        |    |
|                        |    |
+----+----+----+----+----+    +
|    |                        |
|    |                        |
|    |                        |
|    |                        |
+    +    +----+----+    +    +
|         |              |     
|         |              |     
|         |              |_    
|         |              | |  E
+----+----+----+----+----+----+