+-+-+-+-+-+-+-+-+-+-+-+-+-+-+-+
S |     |     |     |   |     |
+ + +-+ + +-+ + +-+ +-+ + +-+ +
|   | | | | | | |       | |   |
+-+-+ + + + + +-+ +-+-+-+ + +-+
|       | |   |   |   |   |   |
+ +-+-+-+ +-+-+ + +-+ + +-+-+ +
| |       |     |     | |     |
+ + +-+-+-+ +-+-+-+-+-+ + +-+-+
|   |     |   |   |     | |   |
+ +-+ +-+ +-+ + + + +-+-+ + +-+
| |   |   |   | | | |   | |   |
+ + +-+ +-+ +-+-+ + + + + +-+ +
| |   |     |   |   | |     | |
+ +-+ +-+-+ + + +-+ + +-+ + + +
|     |     | |   | |   | |   |
+-+-+ + +-+-+ +-+ + +-+ + +-+-+
|     |     | | | | |   |   | |
+ +-+-+-+-+ + + + + + +-+-+ + +
| |       |     | | |     | | |
+ + +-+-+-+-+-+-+ + +-+-+ + + +
| |       |     |   |     |   |
+ +-+-+ + +-+-+ +-+-+ +-+ +-+-+
| |     | |     |   | | |   | |
+ +-+-+ + + +-+-+-+ + + +-+ + +
|     | | |   |   | | |   | | |
+-+-+ +-+ + +-+ + + + +-+ + + +
|     |     |   | | | |   |   |
+ +-+-+ + +-+ +-+ + + + +-+-+ +
|       |     |   |   |   | | E
+-+-+-+-+-+-+-+-+-+-+-+-+-+-+-+