+-+-+-+-+-+
S   |     |
+-+ + + + +
| |   | | |
+ +-+-+-+ +
|   |     |
+-+ + +-+-+
|_|       |
+ +-+-+-+ +
|         E
+-+-+-+-+-+