+-+-+-+-+-+-+-+-+-+-+-+-+-+-+-+-+-+-+-+-+-+-+-+-+-+-+-+-+-+-+-+-+-+-+-+-+-+-+-+-+-+-+-+-+-+
S |   |           |       |   |       |     |       |   |   |       |       |         |   |
+ + + +-+ +-+ +-+-+ +-+-+ + + + +-+ +-+ +-+-+ +-+-+ + + + + + +-+ + + +-+-+ +-+-+-+ + + + +
|   | |   |   |   |   |   | | |   | |   |     |     | |   | | |   | | |     |   | | |   | |
+-+-+ + +-+ +-+ + +-+-+ +-+-+ +-+ + + +-+ +-+-+ +-+ + +-+-+ + + +-+ + + +-+-+ + + + +-+-+ +
| |   |   |     |     |     | |   |     | |   |   |   |     | |   | | | |     |       |   |
+ + +-+-+ +-+-+-+ +-+ +-+-+ + +-+-+-+ +-+ +-+ +-+ +-+-+ +-+-+ +-+-+ + + + +-+-+-+-+ + + +-+
| |           |   |   |   |   |     |   |   | |   |   |       | |   | |   |   |     | |   |
+ +-+-+-+-+-+ + +-+ +-+ + + +-+ +-+ + + +-+ + + +-+-+ +-+ +-+-+ + +-+ +-+-+-+ + +-+-+ +-+-+
|     |       |   |     |         |   |   | |   |   | |   |     |     |     |   |   |     |
+ +-+-+ +-+-+-+-+ +-+-+-+-+ +-+-+-+-+-+-+-+ +-+-+ + + + +-+-+-+ +-+-+-+ +-+ +-+-+ + +-+-+ +
| |     |   |   |   |     | |   |         |     | | |   |   |   |       | | | |   |     | |
+ + +-+-+-+ + + +-+ + +-+ + + + + +-+-+-+ +-+-+ +-+ +-+-+ + + +-+ +-+ +-+ + + + +-+-+-+ + +
| |       | | |   | | | | | | | |   | |   |   | |   |   | |   | |   |   | | | | |   |   | |
+ +-+-+-+ + +-+ +-+ + + + + + + +-+ + + +-+ + + + +-+-+ + +-+-+ +-+ +-+ + + + + +-+ + +-+ +
| |     | |         |   | | | |   | | |     |   | |   |       | |   |   | |       |     | |
+ + +-+ + + +-+-+-+ +-+-+ + + +-+-+ + +-+-+-+-+-+ + + +-+ +-+ + + +-+ +-+ +-+-+ + +-+-+ + +
|   | |   |       |       | |   |   | |       |   | |   |   |   | |   |   |     |     | | |
+-+-+ +-+-+-+-+ + +-+-+-+-+ +-+ + +-+ + +-+-+ + +-+ +-+ +-+-+ +-+ + +-+ +-+ +-+-+-+-+ +-+ +
|     |       | | |       | |         | |       |   | | |     |   | |   |   |       |     |
+ +-+-+ +-+-+ + + + +-+-+ + + +-+ +-+-+ + +-+ +-+-+-+ + + +-+-+ +-+-+ +-+ +-+ +-+-+ +-+-+-+
|     |   | |   |   |     | |   |   |   | |   |   |   |       | |     | |   | |     |     |
+-+-+ +-+ + +-+-+ +-+ +-+ + +-+-+-+ + +-+ + +-+-+ + + +-+ +-+ + + +-+-+ +-+ + +-+-+ + + + +
|   |       |   | |   |   |   |   | | |   |       | |     |   |   |   |     |   | | | | | |
+ + +-+-+ +-+-+ + + +-+-+-+-+ + + + + +-+-+-+-+-+ + +-+-+-+-+-+-+-+ + +-+-+-+-+ + + + + +-+
| | |     |     | | | |       | |   | |       |   |   |   |   |   | |         | |   | |   |
+ + +-+ +-+ +-+-+-+ + + +-+-+-+ +-+-+ + +-+-+ + +-+ + + + + + + + + +-+-+-+-+ + + +-+ +-+ +
| |   |   |         | | |   |     | | |     | |     | | |   | | |   |       | | |       | |
+ +-+ +-+ + +-+-+-+-+ + +-+ + +-+ + + +-+-+ + +-+-+-+-+ +-+ + + +-+-+ +-+-+ + + +-+-+-+-+ +
| | | |   |         |   |   | | |   | |     |     |     |   |   |   |     | |         |   |
+ + + + +-+-+-+-+ +-+-+-+ +-+ + +-+ + + +-+-+-+-+ + +-+-+-+-+-+-+ + +-+-+ +-+-+-+ + +-+ +-+
|   |   |     |     |     | |   |   |   |   |   | | |   |         |             | | |   | |
+-+-+-+-+ +-+-+ +-+ + +-+-+ +-+-+ +-+-+-+ +-+ + + + + + + +-+-+ +-+-+-+-+-+-+-+ + + + +-+ +
|     |   | |   |   |   |   |   |     |   |   |       | |     | |       |     |   | |   | |
+ +-+ + + + + +-+ +-+-+ + +-+ + +-+-+ +-+ + +-+-+ +-+-+ +-+-+ + + +-+-+ + +-+ +-+-+-+-+ + +
| | | | | | | |   |   | | | | |       |     |     |     | |   |     |   | |   |       |   |
+ + + +-+ + + + +-+ + + + + + + +-+ +-+ + +-+ +-+-+ +-+-+ + +-+-+-+-+ +-+ + +-+ +-+-+ +-+-+
| |         | |     |   | |   | |   |   | |     |       | | | |       |   |     |         |
+ +-+-+-+ +-+ +-+-+-+-+-+ + +-+-+ +-+ +-+ + +-+ + +-+-+ + + + + +-+-+-+ +-+-+-+-+ +-+-+-+ +
| |   |       |     |     | |     |   |   |   | |     | |   |   |     |       | |       | |
+ + + +-+-+-+-+-+ + + +-+ + + +-+-+ +-+-+ +-+ + +-+-+ + +-+-+ +-+ +-+ +-+-+-+ + +-+-+-+ + +
|   |     |       | |   |   |   |   |   |   | | |   | |     | |   |   |         |   |   | |
+ +-+-+ + + +-+-+-+ + + +-+-+-+ + +-+ + +-+ + + + + + +-+-+-+ + +-+ +-+ +-+-+ +-+ +-+ +-+-+
| |     |   |     | | |   |   |   |   | |   | | | | |   |     | |   |   |   |   |     |   |
+ +-+-+-+-+-+-+-+ + + +-+ + +-+-+-+ +-+ +-+-+ + + +-+-+ + +-+-+ + +-+ +-+ +-+-+ +-+-+ + + +
| |   |           |   |   |     |   | |     | | | |     | |     |   |   | |   | | |   | | |
+ + + + + +-+-+-+-+-+ + +-+-+-+ +-+ + +-+-+ + + + + +-+-+ + +-+-+ + +-+ + + + + + + +-+ + +
|   |   | |       |   |   |   |     | | |   | | |   |   | |     | |     | | |   |   | | | |
+-+-+-+-+-+ +-+-+ + +-+-+ + + +-+-+-+ + + +-+ + +-+-+-+ + +-+-+ +-+-+-+-+ + +-+-+-+-+ + + +
|       |   |   | |   |   | | |   | | | |     | |     | |       |       | |   |     |   | |
+-+-+-+ + +-+ + + +-+-+ +-+ + + + + + + +-+-+-+ + +-+ + +-+-+-+-+ +-+-+ + +-+ + +-+ + +-+ +
|   | |     | | |     |     | | | |       |     |   |   |     |   |     |   |   |     |   |
+ + + +-+ + +-+ +-+-+ +-+-+-+-+ + +-+-+-+ + +-+-+-+ +-+-+-+ +-+ +-+ +-+-+-+ +-+-+-+-+-+ + +
| |     | | |   |   |       |   |         |   |   | |     | |   |   | |   | |         | | |
+ +-+-+ +-+ + +-+-+ +-+-+ +-+ +-+ +-+-+-+-+-+ +-+ + +-+-+ + + +-+-+-+ + +-+ + +-+-+-+ + + +
|     |     | |                 |     |     |     |   |   | |     |   | |   |   |   |   | |
+-+-+ +-+-+-+ + +-+-+-+-+ +-+-+-+-+-+ + +-+ +-+-+-+-+ +-+ + +-+-+ + +-+ + +-+-+ + + +-+-+ +
|   | |     |   |         |       |     | | |             |       |             | | |   | |
+ + + + +-+ +-+-+-+ +-+-+-+ +-+-+ +-+-+-+ + + + +-+-+ +-+-+ + +-+-+-+-+ + +-+-+-+ + +-+ + +
| |   |   |         |     |   |   |   |   |   | |   | |     |         | |   |   | |   |   |
+ +-+-+-+ +-+-+-+-+-+ +-+ +-+ + +-+ + + + +-+-+ + + + +-+-+-+-+-+-+-+ + +-+ + + + +-+ +-+-+
| |     | |   |   |     |     | |   |   | |     | | | |     |       | | | |   |   |   |   |
+ + +-+ + +-+ + + + + +-+-+-+-+ + +-+-+-+-+ +-+-+-+ + + +-+ + + +-+ + + + +-+-+-+-+ +-+ + +
| | | | | |   | |   |   | |     | |     |   |       |   | |   | | |   |       |     |   | |
+ + + + + + +-+-+-+ +-+ + + +-+-+ + +-+ + +-+-+-+-+ +-+-+ +-+ + + +-+-+-+-+-+-+ +-+ + +-+ +
|   |   |   | |     |   | |       | |   | |   |     | |       |                 |   | |   |
+ +-+-+-+-+-+ + +-+ + +-+ +-+ +-+-+ + +-+ + + + +-+-+ + +-+-+-+-+-+-+-+-+ +-+-+-+ +-+ + +-+
|   |   |     | | | | |   |   |     | |   | |   |   |   |       |       |       |     | | |
+-+ + + + + +-+ + + + + +-+-+-+ +-+-+-+ + + +-+-+ + + +-+-+ +-+ + +-+-+ +-+-+-+-+-+-+-+ + +
| |   |   |     |   | | |   |           | | | |   |   |     |   | |   |         |       | |
+ +-+-+ +-+-+-+-+-+ + + +-+ +-+-+ +-+-+-+ + + + +-+-+-+ +-+-+ +-+ +-+ +-+-+-+-+ + +-+-+-+ +
| |   | |           | |   |   |   |     |   |     |   | |     |       |   |   |   |       |
+ + + + + +-+-+-+-+-+ + + +-+ + +-+ +-+ +-+-+-+-+ + + + + +-+-+ + +-+-+ + + + +-+-+-+ +-+-+
| | |   | |         |   |     |     |   |   |     | |   |   |   | |   | | | |   |     |   |
+ + +-+-+ + +-+-+ + +-+-+ +-+-+-+-+-+ +-+ + + +-+-+-+ +-+ +-+ +-+ + + + + + + +-+ +-+-+-+ +
| |     | |   |   |     | |   |   |   | | | |       | |   |   | | | |   |   |   | |       |
+ +-+-+ + +-+ +-+-+-+-+ +-+ + + + + +-+ + +-+-+-+-+ + + +-+ + + + + +-+-+-+-+-+ + +-+-+-+ +
| |     |     |     |   |   | | |   |   | |       |   | |   | | | | |         |       |   |
+ + +-+-+-+-+-+ +-+ +-+-+ +-+ + +-+-+ +-+ + + +-+-+-+-+ +-+ +-+ + + +-+ +-+-+-+-+ +-+ +-+ +
| | |     |   |   |       | | |   | |   |   |           |       | |   |   |     |   |   | |
+ + +-+-+ + + +-+ +-+-+-+-+ + +-+ + +-+ +-+ +-+-+-+-+-+-+ +-+-+-+ +-+ +-+ + +-+ +-+ +-+ + +
| |       | |   |     |     | |   |   | |       |     |   | |   |   |   |   | |     | |   |
+ +-+-+ +-+ +-+-+ +-+ + +-+-+ +-+-+-+ + +-+-+-+ + +-+ + +-+ + + +-+ +-+ + +-+ +-+-+-+ +-+ +
|       | | |   |   | | |   |       | |   |   | | |   |   |   | |   |   | |   |   |   |   |
+-+-+-+-+ + + + +-+-+ + + + +-+-+-+ + +-+ + + + + + +-+ +-+-+-+ + +-+ +-+ + + +-+ + +-+ +-+
|     | |     |     | | | |       |     |   | | | |   |     |     |   |     |     | |     |
+ + + + + +-+-+-+-+ + + + +-+-+-+ +-+-+ + +-+ + + +-+-+-+-+ + +-+-+ +-+ + +-+-+-+-+ +-+-+ +
| | |     |       |   |         |   |     | | |       | |   |       |   | |   |     |   | |
+ + +-+-+-+ +-+-+ +-+-+-+ +-+ + +-+ + + +-+ + +-+-+-+ + + +-+-+-+-+-+ +-+ + + + +-+-+ +_+ +
| |         |     |       |   |   |   |     |         |   |             |   |   |     | | E
+-+-+-+-+-+-+-+-+-+-+-+-+-+-+-+-+-+-+-+-+-+-+-+-+-+-+-+-+-+-+-+-+-+-+-+-+-+-+-+-+-+-+-+-+-+